{
  "grass": [
    { "x": -7, "y": 0, "z": -6 },
    { "x": -6, "y": 0, "z": -6 },
    { "x": -5, "y": 0, "z": -6 },
    { "x": -4, "y": 0, "z": -6 },
    { "x": -8, "y": 0, "z": -5 },
    { "x": -7, "y": 0, "z": -5 },
    { "x": -6, "y": 0, "z": -5 },
    { "x": -5, "y": 0, "z": -5 },
    { "x": -4, "y": 0, "z": -5 },
    { "x": -3, "y": 0, "z": -5 },
    { "x": -2, "y": 0, "z": -5 },
    { "x": -8, "y": 0, "z": -4 },
    { "x": -7, "y": 0, "z": -4 },
    { "x": -6, "y": 0, "z": -4 },
    { "x": -5, "y": 0, "z": -4 },
    { "x": -4, "y": 0, "z": -4 },
    { "x": -3, "y": 0, "z": -4 },
    { "x": -7, "y": 0, "z": -3 },
    { "x": -6, "y": 0, "z": -3 },
    { "x": -5, "y": 0, "z": -3 },
    { "x": -4, "y": 0, "z": -3 },
    { "x": -6, "y": 0, "z": -2 },
    { "x": -5, "y": 0, "z": -2 },


    { "x": -6, "y": 1, "z": -5 },
    { "x": -5, "y": 1, "z": -5 },
    { "x": -4, "y": 1, "z": -5 },
    { "x": -6, "y": 1, "z": -4 },
    { "x": -5, "y": 1, "z": -4 },
    { "x": -6, "y": 1, "z": -3 }
  ]
}